1 4 3 3 4 1 1 1 1 1 1 1 1 1 1 4
1 0 3 3 3 3 3 3 3 3 3 3 3 3 3 3
1 0 3 3 3 3 3 3 3 3 3 3 3 3 3 3
1 0 0 0 0 0 0 0 0 0 3 3 0 0 0 4
1 0 0 0 0 0 0 0 0 0 3 3 0 0 0 1
1 0 0 0 0 0 5 5 5 5 5 3 0 0 0 1
1 0 0 0 0 0 5 2 2 2 5 3 0 0 0 1
1 0 0 0 0 0 5 2 2 2 5 3 0 0 0 1
1 0 0 0 0 0 5 5 5 5 5 3 0 0 0 1
1 0 0 0 0 0 0 0 0 0 3 3 0 0 0 1
1 0 0 0 0 0 0 0 0 0 3 3 0 0 0 1
1 1 1 1 1 1 1 1 1 4 3 3 4 1 1 1